0000000000000011111111111111110000000000000000000000000000000000
000000000000001000000000000001000000000000.00c0c0c00000000000000
000000000000001000.00b000.00001000000....01111111111111111111111
0000000000000010001111111100000100000111100000000000000000000000
000000000000000000........000000000000000000000.....0b0000000000
0000.00c00.00011111111111100000001111100111111011111111111111111
0000111111101101111010000111101111111100000000000000000000000000
1110011111100000100100010000000001111000000001111111111111111111
0000000111000000000000000000000000000000000000000000000000000000